Genes	Tools				
ANKRD26	MAGMA MSC Nearest PoPS SMR TWAS				
BPTF	MAGMA MSC Nearest PoPS SMR TWAS				
YWHAZ	DEPICT MAGMA Nearest PoPS SMR TWAS				
KAT8	DEPICT MAGMA MSC Nearest SMR TWAS				
GGNBP2	DEPICT MAGMA MSC Nearest SMR TWAS				
ZNF131	DEPICT MAGMA MSC Nearest PoPS SMR				
TFAP2B	FINEMAP MAGMA MSC Nearest PoPS				
CACNA1C	FINEMAP MAGMA MSC Nearest PoPS				
KCNQ5	DEPICT FINEMAP MAGMA MSC Nearest				
MTOR	MAGMA Nearest PoPS SMR TWAS				
ANAPC4	MAGMA MSC Nearest SMR TWAS				
PDXDC1	MAGMA MSC Nearest SMR TWAS				
SLC41A1	MAGMA MSC Nearest SMR TWAS				
RANBP17	MAGMA MSC Nearest SMR TWAS				
HEY2	MAGMA MSC Nearest SMR TWAS				
CCDC171	MAGMA MSC Nearest SMR TWAS				
LUZP1	DEPICT MAGMA MSC SMR TWAS				
ERC2	MAGMA MSC Nearest PoPS TWAS				
NPC1	MAGMA MSC Nearest PoPS TWAS				
PPP1CB	DEPICT MAGMA Nearest PoPS TWAS				
MAP3K3	DEPICT MAGMA MSC Nearest TWAS				
TNRC6B	DEPICT MAGMA MSC Nearest TWAS				
S100PBP	DEPICT MAGMA MSC Nearest TWAS				
UBXN7	DEPICT MAGMA MSC Nearest SMR				
DPY19L1	DEPICT MAGMA MSC Nearest SMR				
RSRC1	DEPICT MAGMA MSC Nearest PoPS				
NRXN1	DEPICT MAGMA MSC Nearest PoPS				
RERE	DEPICT MAGMA MSC Nearest PoPS				
AKAP6	DEPICT MAGMA MSC Nearest PoPS				
NCOR1	DEPICT MAGMA MSC Nearest PoPS				
POU2F1	DEPICT MAGMA MSC Nearest PoPS				
ANKS1B	DEPICT MAGMA MSC Nearest PoPS				
ARNTL	DEPICT MAGMA MSC Nearest PoPS				
MED23	DEPICT MAGMA MSC Nearest PoPS				
DGKI	DEPICT MAGMA MSC Nearest PoPS				
NLGN1	DEPICT MAGMA MSC Nearest PoPS				
MLLT10	DEPICT MAGMA MSC Nearest PoPS				
PCDH9	DEPICT MAGMA MSC Nearest PoPS				
ROBO2	DEPICT MAGMA MSC Nearest PoPS				
MAP4K4	DEPICT MAGMA MSC Nearest PoPS				
DHX36	DEPICT MAGMA MSC Nearest PoPS				
PPP3CA	DEPICT FINEMAP MAGMA PoPS				
DHRS11	MAGMA MSC SMR TWAS				
EFCAB5	MAGMA MSC SMR TWAS				
DDX42	MAGMA MSC SMR TWAS				
TUFM	MAGMA Nearest SMR TWAS				
REEP3	MAGMA Nearest SMR TWAS				
L3MBTL3	MAGMA Nearest SMR TWAS				
C18orf8	DEPICT MAGMA SMR TWAS				
PDE1C	MAGMA Nearest PoPS TWAS				
INVS	MAGMA Nearest PoPS TWAS				
FUBP1	DEPICT MAGMA PoPS TWAS				
NUCKS1	DEPICT MAGMA PoPS TWAS				
CHFR	MAGMA MSC Nearest TWAS				
SLC22A3	MAGMA MSC Nearest TWAS				
PRPH2	MAGMA MSC Nearest TWAS				
TRIM66	MAGMA MSC Nearest TWAS				
POM121C	MAGMA MSC Nearest TWAS				
EVI5	MAGMA MSC Nearest TWAS				
MST1R	MAGMA MSC Nearest TWAS				
OLA1	MAGMA MSC Nearest TWAS				
CHMP3	DEPICT MAGMA Nearest TWAS				
KIAA1429	DEPICT MAGMA Nearest TWAS				
TTC19	DEPICT MAGMA Nearest TWAS				
RMDN1	MAGMA MSC Nearest SMR				
KCNH2	MAGMA MSC Nearest SMR				
MSL2	MAGMA MSC Nearest SMR				
OTUD7A	DEPICT MAGMA Nearest SMR				
CBX5	DEPICT MAGMA Nearest SMR				
ISL1	MAGMA MSC Nearest PoPS				
CEP120	MAGMA MSC Nearest PoPS				
FHIT	MAGMA MSC Nearest PoPS				
SETBP1	MAGMA MSC Nearest PoPS				
PARK2	MAGMA MSC Nearest PoPS				
GRID1	MAGMA MSC Nearest PoPS				
MC4R	MAGMA MSC Nearest PoPS				
GBE1	MAGMA MSC Nearest PoPS				
LINGO2	MAGMA MSC Nearest PoPS				
SPHKAP	MAGMA MSC Nearest PoPS				
AUTS2	MAGMA MSC Nearest PoPS				
MAST2	MAGMA MSC Nearest PoPS				
BDNF	MAGMA MSC Nearest PoPS				
MAML3	MAGMA MSC Nearest PoPS				
KDM4C	MAGMA MSC Nearest PoPS				
FOXO3	MAGMA MSC Nearest PoPS				
GSK3B	DEPICT MSC Nearest PoPS				
NBEA	DEPICT MSC Nearest PoPS				
FAF1	DEPICT MAGMA MSC PoPS				
ELAVL4	DEPICT MAGMA MSC PoPS				
JMJD1C	DEPICT MAGMA MSC PoPS				
RALYL	DEPICT MAGMA Nearest PoPS				
CPNE4	DEPICT MAGMA Nearest PoPS				
RTF1	DEPICT MAGMA Nearest PoPS				
RBFOX1	DEPICT MAGMA Nearest PoPS				
TRIP12	DEPICT MAGMA Nearest PoPS				
ZBTB20	DEPICT MAGMA Nearest PoPS				
KCND3	DEPICT MAGMA Nearest PoPS				
NEGR1	DEPICT MAGMA Nearest PoPS				
SP4	DEPICT MAGMA Nearest PoPS				
SSBP2	DEPICT MAGMA Nearest PoPS				
NRXN3	DEPICT MAGMA Nearest PoPS				
RGS7BP	DEPICT MAGMA Nearest PoPS				
MACF1	DEPICT MAGMA Nearest PoPS				
CADM2	DEPICT MAGMA Nearest PoPS				
KCNB2	DEPICT MAGMA Nearest PoPS				
KDM1A	DEPICT MAGMA Nearest PoPS				
CADPS	DEPICT MAGMA Nearest PoPS				
EHBP1	DEPICT MAGMA Nearest PoPS				
UBE2R2	DEPICT MAGMA Nearest PoPS				
NKAIN2	DEPICT MAGMA Nearest PoPS				
PTBP2	DEPICT MAGMA Nearest PoPS				
ZFHX3	DEPICT MAGMA Nearest PoPS				
CTNNA2	DEPICT MAGMA Nearest PoPS				
RPS6KA5	DEPICT MAGMA MSC Nearest				
DIDO1	DEPICT MAGMA MSC Nearest				
AP3B1	DEPICT MAGMA MSC Nearest				
GFPT1	DEPICT MAGMA MSC Nearest				
CPSF6	DEPICT MAGMA MSC Nearest				
HMGB1	DEPICT MAGMA MSC Nearest				
SSH2	DEPICT MAGMA MSC Nearest				
PDS5B	DEPICT MAGMA MSC Nearest				
MAP2K5	DEPICT MAGMA MSC Nearest				
PDZRN4	DEPICT MAGMA MSC Nearest				
HS6ST3	DEPICT MAGMA MSC Nearest				
WNK1	DEPICT MAGMA MSC Nearest				
SOX2	FINEMAP Nearest PoPS				
AGAP3	FINEMAP MAGMA PoPS				
PSMB6	FINEMAP MAGMA PoPS				
ADPGK	FINEMAP MAGMA Nearest				
BLID	FINEMAP MAGMA Nearest				
ATF7IP	DEPICT FINEMAP Nearest				
RCN1	Nearest SMR TWAS				
VKORC1	MAGMA SMR TWAS				
SNRPC	MAGMA SMR TWAS				
PM20D1	MAGMA SMR TWAS				
SMPD3	MAGMA SMR TWAS				
ADORA2B	MAGMA SMR TWAS				
RPAIN	MAGMA SMR TWAS				
EIF3C	MAGMA SMR TWAS				
VCL	MAGMA SMR TWAS				
ZSWIM7	MAGMA SMR TWAS				
CPSF4	MAGMA SMR TWAS				
PSMB7	MAGMA PoPS TWAS				
ATP13A2	MAGMA PoPS TWAS				
VPS13C	MSC Nearest TWAS				
ZNF646	MAGMA MSC TWAS				
RBM6	MAGMA MSC TWAS				
SH2B1	MAGMA MSC TWAS				
VPS16	MAGMA MSC TWAS				
UHRF1BP1	MAGMA MSC TWAS				
PACRG	MAGMA MSC TWAS				
ZKSCAN5	MAGMA MSC TWAS				
ADCY3	MAGMA Nearest TWAS				
DNAJC11	MAGMA Nearest TWAS				
ARFGEF2	MAGMA Nearest TWAS				
BNIPL	MAGMA Nearest TWAS				
RASA2	MAGMA Nearest TWAS				
NSFL1C	MAGMA Nearest TWAS				
SLC25A37	MAGMA Nearest TWAS				
DYNC1I2	MAGMA Nearest TWAS				
STAU1	DEPICT MAGMA TWAS				
KCNJ11	DEPICT MAGMA TWAS				
EXOSC10	DEPICT MAGMA TWAS				
DCAF7	DEPICT MAGMA TWAS				
SMARCD2	DEPICT MAGMA TWAS				
CHORDC1	Nearest PoPS SMR				
ZNF668	MAGMA MSC SMR				
NRBF2	MAGMA MSC SMR				
NTHL1	MAGMA Nearest SMR				
SLC35E2	DEPICT MAGMA SMR				
ENTPD6	DEPICT MAGMA SMR				
PIAS4	DEPICT MAGMA SMR				
FGFR1	MSC Nearest PoPS				
LSAMP	MSC Nearest PoPS				
LPHN2	MSC Nearest PoPS				
GRM8	MSC Nearest PoPS				
TNRC6C	MSC Nearest PoPS				
DCUN1D4	MAGMA MSC PoPS				
BCL2	MAGMA Nearest PoPS				
PCDH7	MAGMA Nearest PoPS				
MMP16	MAGMA Nearest PoPS				
PHACTR1	MAGMA Nearest PoPS				
FSTL5	MAGMA Nearest PoPS				
LRP1B	MAGMA Nearest PoPS				
PDE4D	MAGMA Nearest PoPS				
PLXNA4	MAGMA Nearest PoPS				
EXT1	MAGMA Nearest PoPS				
FAM19A5	MAGMA Nearest PoPS				
CREB1	MAGMA Nearest PoPS				
PHF2	MAGMA Nearest PoPS				
PCDH17	MAGMA Nearest PoPS				
GABRB3	MAGMA Nearest PoPS				
GABBR2	MAGMA Nearest PoPS				
MACROD2	MAGMA Nearest PoPS				
AKT3	MAGMA Nearest PoPS				
ERBB4	MAGMA Nearest PoPS				
TNIK	MAGMA Nearest PoPS				
RAC1	MAGMA Nearest PoPS				
NRP1	MAGMA Nearest PoPS				
CDH13	MAGMA Nearest PoPS				
MDGA2	MAGMA Nearest PoPS				
ADCY5	MAGMA Nearest PoPS				
TENM2	MAGMA Nearest PoPS				
ENAH	MAGMA Nearest PoPS				
LEPR	MAGMA Nearest PoPS				
MAD1L1	MAGMA Nearest PoPS				
EBF1	MAGMA Nearest PoPS				
CRIM1	MAGMA Nearest PoPS				
LRFN2	MAGMA Nearest PoPS				
RND3	MAGMA Nearest PoPS				
CSMD1	MAGMA Nearest PoPS				
CXXC5	MAGMA Nearest PoPS				
EPHA3	MAGMA Nearest PoPS				
GADD45G	MAGMA Nearest PoPS				
PTPRD	MAGMA Nearest PoPS				
CCNL1	MAGMA Nearest PoPS				
INPP4B	MAGMA Nearest PoPS				
SOX5	MAGMA Nearest PoPS				
PRKG1	MAGMA Nearest PoPS				
MAGI2	MAGMA Nearest PoPS				
LDB2	MAGMA Nearest PoPS				
TNNI3K	MAGMA Nearest PoPS				
MSI2	MAGMA Nearest PoPS				
CNTNAP2	MAGMA Nearest PoPS				
TCF7L2	MAGMA Nearest PoPS				
FOXP1	MAGMA Nearest PoPS				
TRPS1	MAGMA Nearest PoPS				
ATP2B1	MAGMA Nearest PoPS				
BTBD9	DEPICT Nearest PoPS				
NDST3	DEPICT Nearest PoPS				
UBR4	DEPICT Nearest PoPS				
BAI3	DEPICT Nearest PoPS				
LMO3	DEPICT Nearest PoPS				
USP47	DEPICT MAGMA PoPS				
PRKCB	DEPICT MAGMA PoPS				
BAZ1B	DEPICT MAGMA PoPS				
HDAC3	DEPICT MAGMA PoPS				
THRA	DEPICT MAGMA PoPS				
ATXN2L	DEPICT MAGMA PoPS				
SMARCC1	DEPICT MAGMA PoPS				
ZBTB38	DEPICT MAGMA PoPS				
SF3B1	DEPICT MAGMA PoPS				
CTBP2	DEPICT MAGMA PoPS				
GSK3A	DEPICT MAGMA PoPS				
KDM3A	DEPICT MAGMA PoPS				
SLC10A7	MAGMA MSC Nearest				
AGBL4	MAGMA MSC Nearest				
TOX3	MAGMA MSC Nearest				
ESRRA	MAGMA MSC Nearest				
BACE2	MAGMA MSC Nearest				
NUP88	MAGMA MSC Nearest				
ARHGAP15	MAGMA MSC Nearest				
GIPR	MAGMA MSC Nearest				
RSU1	MAGMA MSC Nearest				
KIT	MAGMA MSC Nearest				
FPGT-TNNI3K	MAGMA MSC Nearest				
ZBTB7C	MAGMA MSC Nearest				
CWH43	MAGMA MSC Nearest				
MAST4	MAGMA MSC Nearest				
POU2F2	MAGMA MSC Nearest				
GRIN3A	MAGMA MSC Nearest				
ADARB1	MAGMA MSC Nearest				
DMXL2	MAGMA MSC Nearest				
KIAA0391	MAGMA MSC Nearest				
POU6F2	MAGMA MSC Nearest				
GOLGA2	MAGMA MSC Nearest				
JADE2	MAGMA MSC Nearest				
TAL1	MAGMA MSC Nearest				
FBXL17	MAGMA MSC Nearest				
PTPRN	MAGMA MSC Nearest				
DNAH10	MAGMA MSC Nearest				
NTNG1	MAGMA MSC Nearest				
OGFOD1	MAGMA MSC Nearest				
NADK	MAGMA MSC Nearest				
TRPM3	MAGMA MSC Nearest				
SLC39A8	MAGMA MSC Nearest				
ZC3H4	MAGMA MSC Nearest				
ZMIZ2	MAGMA MSC Nearest				
RGS17	MAGMA MSC Nearest				
KIAA1598	MAGMA MSC Nearest				
INADL	MAGMA MSC Nearest				
BNC2	MAGMA MSC Nearest				
GLP2R	MAGMA MSC Nearest				
BRWD1	MAGMA MSC Nearest				
HIVEP1	MAGMA MSC Nearest				
C12orf42	MAGMA MSC Nearest				
NBEAL1	MAGMA MSC Nearest				
MFAP3	MAGMA MSC Nearest				
MALRD1	MAGMA MSC Nearest				
CCSER1	MAGMA MSC Nearest				
TMEM161B	MAGMA MSC Nearest				
POC5	MAGMA MSC Nearest				
ARHGAP28	MAGMA MSC Nearest				
DCST2	MAGMA MSC Nearest				
ZCCHC7	MAGMA MSC Nearest				
GAB2	MAGMA MSC Nearest				
ABCG2	MAGMA MSC Nearest				
SKAP1	MAGMA MSC Nearest				
DGKG	MAGMA MSC Nearest				
CDH22	MAGMA MSC Nearest				
VSX1	MAGMA MSC Nearest				
CADM1	MAGMA MSC Nearest				
CRTAC1	MAGMA MSC Nearest				
CCDC85A	MAGMA MSC Nearest				
LMX1B	MAGMA MSC Nearest				
CCDC92	MAGMA MSC Nearest				
PARD3B	MAGMA MSC Nearest				
RELN	MAGMA MSC Nearest				
CAST	MAGMA MSC Nearest				
DEFB136	MAGMA MSC Nearest				
PGPEP1	MAGMA MSC Nearest				
GPR61	MAGMA MSC Nearest				
POU6F1	DEPICT MSC Nearest				
ZC3HAV1	DEPICT MSC Nearest				
UBAP2	DEPICT MAGMA MSC				
ZNF574	DEPICT MAGMA MSC				
PLCB3	DEPICT MAGMA MSC				
ETV5	DEPICT MAGMA MSC				
IPO9	DEPICT MAGMA Nearest				
ANKRD6	DEPICT MAGMA Nearest				
PSMD3	DEPICT MAGMA Nearest				
RTN4RL1	DEPICT MAGMA Nearest				
CADPS2	DEPICT MAGMA Nearest				
STK24	DEPICT MAGMA Nearest				
SYNCRIP	DEPICT MAGMA Nearest				
KCNJ12	DEPICT MAGMA Nearest				
CALN1	DEPICT MAGMA Nearest				
CDH7	DEPICT MAGMA Nearest				
GTF2I	DEPICT MAGMA Nearest				
IGSF9B	DEPICT MAGMA Nearest				
SYT16	DEPICT MAGMA Nearest				
SYT4	DEPICT MAGMA Nearest				
AP1S1	DEPICT MAGMA Nearest				
AXIN1	DEPICT MAGMA Nearest				
ANKRD28	DEPICT MAGMA Nearest				
ZRANB1	DEPICT MAGMA Nearest				
SETD5	DEPICT MAGMA Nearest				
ZBTB7A	DEPICT MAGMA Nearest				
ZSWIM6	DEPICT MAGMA Nearest				
RTN4	DEPICT MAGMA Nearest				
FBXO21	DEPICT MAGMA Nearest				
DIAPH1	DEPICT MAGMA Nearest				
CPNE3	DEPICT MAGMA Nearest				
RABEP1	DEPICT MAGMA Nearest				
ZFP64	DEPICT MAGMA Nearest				
MAP2K1	DEPICT MAGMA Nearest				
CDKAL1	DEPICT MAGMA Nearest				
GLTPD2	FINEMAP MAGMA				
PLD2	FINEMAP MAGMA				
VMO1	FINEMAP MAGMA				
TMUB1	FINEMAP MAGMA				
PYGO2	FINEMAP MAGMA				
TBL2	FINEMAP MAGMA				
CCDC84	FINEMAP MAGMA				
LENEP	FINEMAP MAGMA				
FLAD1	FINEMAP MAGMA				
BRINP2	FINEMAP MAGMA				
DCP1B	FINEMAP MAGMA				
ADAM15	FINEMAP MAGMA				
MST1L	SMR TWAS				
STAG3L1	SMR TWAS				
DNALI1	MSC TWAS				
C1orf222	MSC TWAS				
CBLN1	Nearest TWAS				
FARP1	MAGMA TWAS				
STAU2	MAGMA TWAS				
GSDMA	MAGMA TWAS				
CAMTA1	MAGMA TWAS				
ZNF605	MAGMA TWAS				
UBE2W	MAGMA TWAS				
SULT1A2	MAGMA TWAS				
TMEM241	MAGMA TWAS				
BMP8A	MAGMA TWAS				
FBF1	MAGMA TWAS				
ZNF362	MAGMA TWAS				
USP35	MAGMA TWAS				
FAM180B	MAGMA TWAS				
GALNT10	MAGMA TWAS				
TRIM47	MAGMA TWAS				
NPIPB9	MAGMA TWAS				
THUMPD3	MAGMA TWAS				
TRIM73	MAGMA TWAS				
LAT	MAGMA TWAS				
PI4K2B	MAGMA TWAS				
CDK5RAP3	MAGMA TWAS				
SCG3	MAGMA TWAS				
RTBDN	MAGMA TWAS				
NDUFS3	MAGMA TWAS				
MTCH2	MAGMA TWAS				
RNF123	MAGMA TWAS				
IQCK	MAGMA TWAS				
TRMT61B	MAGMA TWAS				
SGCB	MAGMA TWAS				
SULT1A1	MAGMA TWAS				
C1QTNF4	MAGMA TWAS				
MYO19	MAGMA TWAS				
GTF2IRD2	MAGMA TWAS				
NFATC2IP	MAGMA TWAS				
NT5C2	MAGMA TWAS				
SLC25A12	MAGMA TWAS				
PCED1A	MAGMA SMR				
MRM1	MAGMA SMR				
ZBTB7B	MAGMA SMR				
PSMA6	MAGMA SMR				
TEX40	MAGMA SMR				
PRDX5	MAGMA SMR				
MRPS26	MAGMA SMR				
KCNK4	MAGMA SMR				
MEAF6	DEPICT SMR				
HES1	Nearest PoPS				
POLG	Nearest PoPS				
CDH8	Nearest PoPS				
TCF4	Nearest PoPS				
RBM26	Nearest PoPS				
EPHA7	Nearest PoPS				
PDE3A	Nearest PoPS				
MCTP2	Nearest PoPS				
GLRA1	Nearest PoPS				
C4orf32	Nearest PoPS				
TBL1XR1	Nearest PoPS				
VWC2	Nearest PoPS				
FBXW7	Nearest PoPS				
GRM7	Nearest PoPS				
SHANK2	Nearest PoPS				
UNC5D	Nearest PoPS				
SOX4	Nearest PoPS				
FANCL	Nearest PoPS				
FAM135B	Nearest PoPS				
HACE1	Nearest PoPS				
ZFHX4	Nearest PoPS				
GPR26	Nearest PoPS				
SEL1L	Nearest PoPS				
SCAPER	Nearest PoPS				
LHCGR	Nearest PoPS				
RIT2	MAGMA PoPS				
EP300	MAGMA PoPS				
PCSK1	MAGMA PoPS				
NCAM1	MAGMA PoPS				
JUND	MAGMA PoPS				
TNKS2	MAGMA PoPS				
NTM	MAGMA PoPS				
CREBBP	MAGMA PoPS				
DNMT3A	MAGMA PoPS				
PSIP1	MAGMA PoPS				
PSMD2	MAGMA PoPS				
SGCZ	MAGMA PoPS				
POR	MAGMA PoPS				
PSMA5	MAGMA PoPS				
WWP1	MAGMA PoPS				
EPHB1	MAGMA PoPS				
FBRS	MAGMA PoPS				
CACNA2D2	MAGMA PoPS				
INS	MAGMA PoPS				
FOXP2	MAGMA PoPS				
EFNA5	MAGMA PoPS				
ATP9A	MAGMA PoPS				
PYGB	MAGMA PoPS				
PAX6	MAGMA PoPS				
BBS4	MAGMA PoPS				
ZNF423	MAGMA PoPS				
FAM184A	MAGMA PoPS				
SEMA6D	MAGMA PoPS				
PAN3	MAGMA PoPS				
DNAJB2	MAGMA PoPS				
PPP6R3	MAGMA PoPS				
MAP1LC3A	MAGMA PoPS				
PSMC5	MAGMA PoPS				
ACP1	MAGMA PoPS				
KCTD8	MAGMA PoPS				
PTPRM	MAGMA PoPS				
ARHGAP35	MAGMA PoPS				
WARS2	MAGMA PoPS				
C11orf96	MAGMA PoPS				
PLEKHA5	MAGMA PoPS				
PAX5	MAGMA PoPS				
PCSK7	MAGMA PoPS				
ADARB2	MAGMA PoPS				
MEF2C	MAGMA PoPS				
AFF3	MAGMA PoPS				
MPPED2	MAGMA PoPS				
SMARCC2	MAGMA PoPS				
RC3H1	MAGMA PoPS				
ARHGEF7	MAGMA PoPS				
SMAD3	MAGMA PoPS				
CMIP	MAGMA PoPS				
HDAC5	MAGMA PoPS				
RNF20	MAGMA PoPS				
MAP2K2	MAGMA PoPS				
BAD	MAGMA PoPS				
SNX14	MAGMA PoPS				
DPF3	MAGMA PoPS				
DLG2	MAGMA PoPS				
TLE1	MAGMA PoPS				
RORA	MAGMA PoPS				
FAM65B	MAGMA PoPS				
DSCAM	MAGMA PoPS				
SP1	MAGMA PoPS				
PCDH8	MAGMA PoPS				
ADCY6	MAGMA PoPS				
KCNIP4	MAGMA PoPS				
FAT3	MAGMA PoPS				
DZIP3	MAGMA PoPS				
HOXA9	MAGMA PoPS				
XKR6	MAGMA PoPS				
GAS7	MAGMA PoPS				
SYT14	MAGMA PoPS				
PSMC3	MAGMA PoPS				
BCL11A	MAGMA PoPS				
MFHAS1	MAGMA PoPS				
HMGA1	MAGMA PoPS				
NRG1	MAGMA PoPS				
GAD1	MAGMA PoPS				
LHX9	MAGMA PoPS				
VAV3	MAGMA PoPS				
ARNT2	MAGMA PoPS				
KCTD1	MAGMA PoPS				
ABI2	DEPICT PoPS				
BRD8	DEPICT PoPS				
TCF12	DEPICT PoPS				
SPATS2	DEPICT PoPS				
PBX3	DEPICT PoPS				
SOX11	DEPICT PoPS				
FIBCD1	MSC Nearest				
KRT37	MSC Nearest				
PSD4	MSC Nearest				
ZSCAN31	MSC Nearest				
ZNF280D	MSC Nearest				
MCTP1	MSC Nearest				
SALL3	MSC Nearest				
GNL2	MSC Nearest				
CCDC88B	MAGMA MSC				
TMEM52	MAGMA MSC				
GOLGA3	MAGMA MSC				
YME1L1	MAGMA MSC				
IPP	MAGMA MSC				
TIPIN	MAGMA MSC				
TEX10	MAGMA MSC				
ZCCHC6	MAGMA MSC				
FAM200A	MAGMA MSC				
SHISA4	MAGMA MSC				
SWI5	MAGMA MSC				
RPAP2	MAGMA MSC				
ZNF789	MAGMA MSC				
NCOA7	MAGMA MSC				
ABCC8	MAGMA MSC				
RESP18	MAGMA MSC				
PPP2R3A	MAGMA MSC				
KIAA1522	MAGMA MSC				
STRADA	MAGMA MSC				
PIK3R3	MAGMA MSC				
LRRC66	MAGMA MSC				
PGBD1	MAGMA MSC				
LMOD1	MAGMA MSC				
FAM212B	MAGMA MSC				
C14orf159	MAGMA MSC				
ZKSCAN4	MAGMA MSC				
FTSJ3	MAGMA MSC				
THAP3	MAGMA MSC				
NIM1K	MAGMA MSC				
BBS2	MAGMA MSC				
METAP1D	MAGMA MSC				
SLX4	MAGMA MSC				
CYP20A1	MAGMA MSC				
SKOR1	MAGMA MSC				
BOLL	MAGMA MSC				
PLCL1	MAGMA MSC				
FNDC5	MAGMA MSC				
FAIM2	MAGMA MSC				
HOOK2	MAGMA MSC				
AP3M1	MAGMA MSC				
NOS3	MAGMA MSC				
NKAPL	MAGMA MSC				
ZNHIT3	MAGMA MSC				
PTCD1	MAGMA MSC				
RFTN2	MAGMA MSC				
ASPM	DEPICT MSC				
CIPC	MAGMA Nearest				
EPB41L4B	MAGMA Nearest				
SLC8A1	MAGMA Nearest				
RNF103_CHMP3	MAGMA Nearest				
CCNE1	MAGMA Nearest				
RASGRF1	MAGMA Nearest				
HYOU1	MAGMA Nearest				
CELF1	MAGMA Nearest				
CRIPT	MAGMA Nearest				
RARB	MAGMA Nearest				
PNOC	MAGMA Nearest				
SLAIN1	MAGMA Nearest				
LONRF2	MAGMA Nearest				
NEK6	MAGMA Nearest				
RBBP6	MAGMA Nearest				
VIT	MAGMA Nearest				
BRINP3	MAGMA Nearest				
TTC12	MAGMA Nearest				
NPY	MAGMA Nearest				
SMCO4	MAGMA Nearest				
VEGFA	MAGMA Nearest				
BCL11B	MAGMA Nearest				
PIGK	MAGMA Nearest				
ISCA1	MAGMA Nearest				
MBD2	MAGMA Nearest				
ANAPC10	MAGMA Nearest				
FSHB	MAGMA Nearest				
ATP5J2	MAGMA Nearest				
GIPC2	MAGMA Nearest				
FTO	MAGMA Nearest				
OLFM4	MAGMA Nearest				
PACS1	MAGMA Nearest				
OPCML	MAGMA Nearest				
TUSC3	MAGMA Nearest				
SPATA18	MAGMA Nearest				
C2	MAGMA Nearest				
MFAP2	MAGMA Nearest				
ZBTB10	MAGMA Nearest				
IST1	MAGMA Nearest				
ZDHHC21	MAGMA Nearest				
CPS1	MAGMA Nearest				
CD47	MAGMA Nearest				
TEX29	MAGMA Nearest				
DLK1	MAGMA Nearest				
SLIT2	MAGMA Nearest				
POU3F3	MAGMA Nearest				
CNNM2	MAGMA Nearest				
NCR3LG1	MAGMA Nearest				
GNRH2	MAGMA Nearest				
KLF3	MAGMA Nearest				
RPTOR	MAGMA Nearest				
GALK1	MAGMA Nearest				
KCTD15	MAGMA Nearest				
LYRM2	MAGMA Nearest				
TMEM18	MAGMA Nearest				
SEC16B	MAGMA Nearest				
TRAF3	MAGMA Nearest				
ANTXR2	MAGMA Nearest				
RBM19	MAGMA Nearest				
TH	MAGMA Nearest				
ARG1	MAGMA Nearest				
SMIM21	MAGMA Nearest				
GALC	MAGMA Nearest				
MTIF3	MAGMA Nearest				
NSUN3	MAGMA Nearest				
ABHD17C	MAGMA Nearest				
TBX15	MAGMA Nearest				
AADAT	MAGMA Nearest				
PPP1R3A	MAGMA Nearest				
ZNF521	MAGMA Nearest				
DMRTA2	MAGMA Nearest				
EIF4G1	MAGMA Nearest				
KLHL32	MAGMA Nearest				
NUP210	MAGMA Nearest				
KLF1	MAGMA Nearest				
ASXL3	MAGMA Nearest				
SGK223	MAGMA Nearest				
PCGF5	MAGMA Nearest				
ASIC2	MAGMA Nearest				
PURG	MAGMA Nearest				
ADK	MAGMA Nearest				
KLF14	MAGMA Nearest				
WSCD2	MAGMA Nearest				
PA2G4	MAGMA Nearest				
BCDIN3D	MAGMA Nearest				
TLR4	MAGMA Nearest				
C6orf106	MAGMA Nearest				
P2RX4	MAGMA Nearest				
HSD17B12	MAGMA Nearest				
MLXIPL	MAGMA Nearest				
GPRC5B	MAGMA Nearest				
CLUAP1	MAGMA Nearest				
GALNT16	MAGMA Nearest				
PRMT7	MAGMA Nearest				
SPOCK1	MAGMA Nearest				
PFKP	DEPICT Nearest				
PDCD6IP	DEPICT Nearest				
KCNJ3	DEPICT Nearest				
EHMT1	DEPICT Nearest				
ATXN1L	DEPICT Nearest				
EFR3A	DEPICT Nearest				
ZNF609	DEPICT Nearest				
PPP2R2C	DEPICT Nearest				
GPR88	DEPICT Nearest				
CELF4	DEPICT Nearest				
VRK1	DEPICT Nearest				
USP3	DEPICT Nearest				
MON1B	DEPICT MAGMA				
ANKRD13B	DEPICT MAGMA				
YEATS4	DEPICT MAGMA				
BUD31	DEPICT MAGMA				
HPCA	DEPICT MAGMA				
H3F3B	DEPICT MAGMA				
MOB4	DEPICT MAGMA				
PDAP1	DEPICT MAGMA				
ARHGEF26	DEPICT MAGMA				
ICA1L	DEPICT MAGMA				
ARPC1A	DEPICT MAGMA				
BBX	DEPICT MAGMA				
ZNF664	DEPICT MAGMA				
SNX32	DEPICT MAGMA				
CFL1	DEPICT MAGMA				
COPG2	DEPICT MAGMA				
PIK3R2	DEPICT MAGMA				
C16orf72	DEPICT MAGMA				
CSPG5	DEPICT MAGMA				
SETD1A	DEPICT MAGMA				
MED24	DEPICT MAGMA				
NUDCD3	DEPICT MAGMA				
STX1B	DEPICT MAGMA				
GNB1	DEPICT MAGMA				
LIN7C	DEPICT MAGMA				
MLLT11	DEPICT MAGMA				
AAK1	DEPICT MAGMA				
MAST3	DEPICT MAGMA				
GNAI3	DEPICT MAGMA				
RALY	DEPICT MAGMA				
YEATS2	DEPICT MAGMA				
DCAF12	DEPICT MAGMA				
RNF168	DEPICT MAGMA				
CBX8	DEPICT MAGMA				
RQCD1	DEPICT MAGMA				
FBXL19	DEPICT MAGMA				
GRIK5	DEPICT MAGMA				
NAV1	DEPICT MAGMA				
PTPRA	DEPICT MAGMA				
RGS6	DEPICT MAGMA				
PHF13	DEPICT MAGMA				
CAMKK2	DEPICT MAGMA				
UBR2	DEPICT MAGMA				
ZZZ3	DEPICT MAGMA				
HIP1	DEPICT MAGMA				
KIAA0754	DEPICT MAGMA				
POC1B	DEPICT MAGMA				
ARRB2	FINEMAP				
ZSCAN32	FINEMAP				
FKBP4	FINEMAP				
SLC50A1	FINEMAP				
DDIT4L	FINEMAP				
ST6GALNAC3	FINEMAP				
TBC1D16	FINEMAP				
HAS3	FINEMAP				
ADAR	FINEMAP				
BUD13	FINEMAP				
ASTN1	FINEMAP				
LRTM2	FINEMAP				
PRED58	FINEMAP				
PKLR	FINEMAP				
MCM3	FINEMAP				
DPM3	FINEMAP				
MED11	FINEMAP				
EFNA1	FINEMAP				
RHBDD2	FINEMAP				
PHLDB1	FINEMAP				
ZNF174	FINEMAP				
RFC2	FINEMAP				
CHTF8	FINEMAP				
TRIM49	FINEMAP				
TMPRSS5	FINEMAP				
TSPAN9	FINEMAP				
ADIPOR2	FINEMAP				
AP001816.1	FINEMAP				
FDPS	FINEMAP				
AC138783.12	TWAS				
RP11-1348G14.6	TWAS				
DNAJC27_AS1	TWAS				
KRT18P34	TWAS				
USP3-AS1	TWAS				
RP11-22P6.2	TWAS				
MST1P2	TWAS				
NPIPB7	TWAS				
CTC-524C5.2	TWAS				
NFATC3	TWAS				
RP11-267M23.4	TWAS				
FOXE3	TWAS				
FAM85B	TWAS				
TNFRSF25	TWAS				
RP11-339B21.15	TWAS				
RP11-75C9.1	TWAS				
LOC100289187	TWAS				
CTB-75G16.3	TWAS				
PMS2P3	TWAS				
RMST	TWAS				
SLC2A3P4	TWAS				
OXCT2P1	TWAS				
SNORA16	TWAS				
LINC00614	TWAS				
CTD-2380F24.1	TWAS				
RAB7L1	TWAS				
RP11-1348G14.4	TWAS				
RP11-62H7.2	TWAS				
FAM86B3P	TWAS				
FKSG48	TWAS				
PMS2CL	TWAS				
AC068039.4	TWAS				
RP11-555M1.3	TWAS				
NTAN1P2	TWAS				
RP11-339B21.14	TWAS				
DNAH10OS	TWAS				
LINC00163	TWAS				
LINC00202-1	TWAS				
AC090945.1	TWAS				
SLC26A9	TWAS				
RP11-624M8.1	TWAS				
RP11-339B21.13	TWAS				
RP11-552F3.9	TWAS				
LRRC37A6P	TWAS				
RP1-283E3.4	SMR				
MINOS1P1	SMR				
C11orf75	SMR				
RP11-51F16.5	SMR				
RP4-635E18.7	SMR				
RP11-196G11.4	SMR				
ATP8A2P2	SMR				
PMS2P10	SMR				
DLG1	PoPS				
LRRC41	PoPS				
PAK1	PoPS				
ATP9B	PoPS				
CHD9	PoPS				
PAPOLA	PoPS				
TTC37	PoPS				
MED13L	PoPS				
B3GAT1	PoPS				
FRY	PoPS				
PRR16	PoPS				
RAPGEF6	PoPS				
C16orf45	PoPS				
KCNC1	PoPS				
GRB2	PoPS				
EP400	PoPS				
PTK2	PoPS				
GCC2	PoPS				
USP7	PoPS				
MAP3K13	PoPS				
MEIS2	PoPS				
SON	PoPS				
PSMD11	PoPS				
CDK17	PoPS				
MBD5	PoPS				
NKAIN3	PoPS				
PALM2	PoPS				
UBN2	PoPS				
DHX15	PoPS				
NR2C2	PoPS				
AGTPBP1	PoPS				
NKTR	PoPS				
FRYL	PoPS				
RHOBTB2	PoPS				
PSMD5	PoPS				
ASH1L	PoPS				
PSMF1	PoPS				
GNAO1	PoPS				
PFKL	PoPS				
KCNK10	PoPS				
TTC3	PoPS				
PAQR3	PoPS				
ASTN2	PoPS				
ZNF827	PoPS				
TSHZ1	PoPS				
BICD1	PoPS				
CORO1C	PoPS				
KALRN	PoPS				
NF1	PoPS				
NCK2	PoPS				
AP2B1	PoPS				
ATXN2	PoPS				
SMCHD1	PoPS				
IPO5	PoPS				
ESR1	PoPS				
DVL1	PoPS				
SNCA	PoPS				
RIMS1	PoPS				
SMG1	PoPS				
FOXO1	PoPS				
CBLN2	PoPS				
GFRA2	PoPS				
IRF2BPL	PoPS				
ADCY1	PoPS				
FOXG1	PoPS				
HERC1	PoPS				
MTF2	PoPS				
MTUS2	PoPS				
CHGB	PoPS				
SMAD2	PoPS				
VSTM2B	PoPS				
NOL4	PoPS				
PPP3CB	PoPS				
C7orf50	PoPS				
TBCEL	PoPS				
FAM171B	PoPS				
MDM2	PoPS				
PPFIA2	PoPS				
CDK13	PoPS				
DZIP1	PoPS				
CHD2	PoPS				
NR4A1	PoPS				
NAP1L5	PoPS				
CNTN1	PoPS				
IARS	PoPS				
MED13	PoPS				
TRA2A	PoPS				
SCLT1	PoPS				
ABL1	PoPS				
UBE2H	PoPS				
TBX3	PoPS				
PDE7A	PoPS				
PSMD4	PoPS				
GRIK3	PoPS				
CACNB2	PoPS				
TOX2	PoPS				
CLCN3	PoPS				
TFAP2A	PoPS				
CRMP1	PoPS				
MC3R	PoPS				
BRD2	PoPS				
C20orf194	PoPS				
STXBP1	PoPS				
NOVA1	PoPS				
FZD3	PoPS				
HDAC1	PoPS				
LDB1	PoPS				
FOSB	PoPS				
GFRA1	PoPS				
TOP2B	PoPS				
SH3GL2	PoPS				
KLF13	PoPS				
LPIN1	PoPS				
DOCK7	PoPS				
STMN2	PoPS				
BACH2	PoPS				
CALM1	PoPS				
EVL	PoPS				
ERC1	PoPS				
MLXIP	PoPS				
SOS1	PoPS				
RBFOX3	PoPS				
TIA1	PoPS				
SAMD3	PoPS				
PTPRZ1	PoPS				
GALNT13	PoPS				
PSMC2	PoPS				
UBE2I	PoPS				
RAB37	PoPS				
YWHAE	PoPS				
WDR1	PoPS				
SLC8A3	PoPS				
GPI	PoPS				
STMN3	PoPS				
CAMK2D	PoPS				
PI4K2A	PoPS				
ZMYND8	PoPS				
NRP2	PoPS				
EPHA5	PoPS				
CASD1	PoPS				
HDAC9	PoPS				
FAM188A	PoPS				
NPTX2	PoPS				
CBLB	PoPS				
RAF1	PoPS				
CNRIP1	PoPS				
LARP1	PoPS				
ZBTB16	PoPS				
KIF21A	PoPS				
KIAA1244	PoPS				
EPRS	PoPS				
GRIN2B	PoPS				
STAT3	PoPS				
MYO5A	PoPS				
TRIM27	PoPS				
CNTNAP4	PoPS				
TRMT13	PoPS				
NEUROD1	PoPS				
ADCY8	PoPS				
DDX46	PoPS				
GNB2	PoPS				
FAM92A1	PoPS				
ZNF292	PoPS				
BMPER	PoPS				
CTCF	PoPS				
CLASP2	PoPS				
HSP90AA1	PoPS				
CLOCK	PoPS				
PRKCE	PoPS				
PSMA4	PoPS				
DENND5A	PoPS				
PPP1R12B	PoPS				
STX1A	PoPS				
KCNH8	PoPS				
NPEPPS	PoPS				
HOMER2	PoPS				
ID4	PoPS				
CACNA1A	PoPS				
FUT9	PoPS				
GRIN1	PoPS				
TDG	PoPS				
MYCBP2	PoPS				
GNAQ	PoPS				
TRAF4	PoPS				
SLC20A1	PoPS				
BCL2L1	PoPS				
GTDC1	PoPS				
RELA	PoPS				
HIF1A	PoPS				
SMIM14	PoPS				
MED28	PoPS				
HSF1	PoPS				
DST	PoPS				
KMT2A	PoPS				
FBXW11	PoPS				
PRRC2A	PoPS				
CTDSPL	PoPS				
HMGCLL1	PoPS				
SMC5	PoPS				
AKAP5	PoPS				
SRGAP3	PoPS				
RASAL2	PoPS				
CHD5	PoPS				
KCNB1	PoPS				
ZNF462	PoPS				
USP22	PoPS				
KCTD16	PoPS				
RALGAPA1	PoPS				
SREK1	PoPS				
PDE8B	PoPS				
NUMA1	PoPS				
SV2C	PoPS				
DCC	PoPS				
CHN1	PoPS				
PNN	PoPS				
SNAP91	PoPS				
SRF	PoPS				
UBC	PoPS				
CCDC88A	PoPS				
OTUD4	MSC				
CTD-2330K9.3	MSC				
ZBTB41	MSC				
SNIP1	MSC				
ZKSCAN8	MSC				
EIF2B5	Nearest				
LCORL	Nearest				
C15orf41	Nearest				
PUF60	Nearest				
SRSF6	Nearest				
HDAC7	Nearest				
ALCAM	Nearest				
PCDH18	Nearest				
NFIL3	Nearest				
ARAP1	Nearest				
AHR	Nearest				
ACVR2A	Nearest				
PRIM2	Nearest				
AC017081.1	Nearest				
KCNJ6	Nearest				
C21orf49	Nearest				
HTR1E	Nearest				
FNTB	Nearest				
TYRP1	Nearest				
RAB15	Nearest				
PIK3C2G	Nearest				
CEP164	Nearest				
BMP2	Nearest				
SDK2	Nearest				
AC138647.1	Nearest				
NRSN1	Nearest				
KIAA1841	Nearest				
GNGT1	Nearest				
LPHN3	Nearest				
PRELID2	Nearest				
LINC01098	Nearest				
CLNK	Nearest				
LMO7	Nearest				
MAN1A1	Nearest				
FAM83B	Nearest				
TMEM182	Nearest				
CRH	Nearest				
AC011997.1	Nearest				
MYEOV	Nearest				
AC002553.1	Nearest				
F13B	Nearest				
TMEM38B	Nearest				
TFPI	Nearest				
SLC9C2	Nearest				
CHURC1-FNTB	Nearest				
TMIE	Nearest				
C14orf64	Nearest				
FLJ00325	Nearest				
TLE4	Nearest				
ZNF821	Nearest				
DKFZP761K2322	Nearest				
STON1-GTF2A1L	Nearest				
HINT1	Nearest				
ZCWPW2	Nearest				
ARSJ	Nearest				
RNF135	Nearest				
CCDC59	Nearest				
ZNF385D	Nearest				
AL133318.1	Nearest				
SQRDL	Nearest				
SH3RF3	Nearest				
UBE2E3	Nearest				
CARD11	Nearest				
DEFB116	Nearest				
SLC16A7	Nearest				
YTHDF3	Nearest				
SYT10	Nearest				
RP11-297M9.1	Nearest				
SLCO3A1	Nearest				
HSD17B4	Nearest				
EFTUD2	Nearest				
FBXO33	Nearest				
DYRK2	Nearest				
CCDC81	Nearest				
SGOL1	Nearest				
SNX4	Nearest				
LZTS1	Nearest				
SIPA1L1	Nearest				
CAMK1G	Nearest				
CCK	Nearest				
C4orf33	Nearest				
NEDD1	Nearest				
JAZF1	Nearest				
CUX2	Nearest				
C17orf82	Nearest				
RP11-723G8.2	Nearest				
AC131935.1	Nearest				
CPNE8	Nearest				
KCNT2	Nearest				
KIF2B	Nearest				
CDYL2	Nearest				
GGNBP1	Nearest				
CDH9	Nearest				
STXBP6	Nearest				
GTF2A1L	Nearest				
RP11-180C1.1	Nearest				
PSAT1	Nearest				
RNF144B	Nearest				
SLC30A10	Nearest				
PRKD1	Nearest				
GNPDA2	Nearest				
EDEM1	Nearest				
CBLN4	Nearest				
OR4C15	Nearest				
ZEB2	Nearest				
RP11-58C22.1	Nearest				
UBE3D	Nearest				
ETAA1	Nearest				
RP11-295D22.1	Nearest				
OFCC1	Nearest				
IFNGR1	Nearest				
LRRFIP2	Nearest				
METTL4	Nearest				
TECRL	Nearest				
TRPC4AP	Nearest				
ADAMTSL3	Nearest				
TRIB2	Nearest				
RP11-463D19.2	Nearest				
TMEM239	MAGMA				
FEZF1	MAGMA				
FAM219A	MAGMA				
CMTR2	MAGMA				
KRTAP4-12	MAGMA				
ATF6B	MAGMA				
KRTAP2-2	MAGMA				
SLC4A1	MAGMA				
BYSL	MAGMA				
ZNF785	MAGMA				
SLC7A6	MAGMA				
ACOT12	MAGMA				
SLC52A1	MAGMA				
ESYT1	MAGMA				
POLK	MAGMA				
GP1BA	MAGMA				
MSL1	MAGMA				
MRPL10	MAGMA				
GDF15	MAGMA				
SIRPB2	MAGMA				
ZBTB12	MAGMA				
DNAI1	MAGMA				
C2orf49	MAGMA				
ZSCAN9	MAGMA				
ZG16	MAGMA				
ERG	MAGMA				
ARRDC2	MAGMA				
PPP1R13B	MAGMA				
AATK	MAGMA				
C16orf54	MAGMA				
STK16	MAGMA				
ARID3C	MAGMA				
SEMA4D	MAGMA				
MMS22L	MAGMA				
BAK1	MAGMA				
AGPAT1	MAGMA				
BANK1	MAGMA				
NINL	MAGMA				
TBC1D3H	MAGMA				
SPN	MAGMA				
BBC3	MAGMA				
MRPL38	MAGMA				
SYNGAP1	MAGMA				
HOXA13	MAGMA				
HMGN1	MAGMA				
SLC22A2	MAGMA				
OXT	MAGMA				
SHC1	MAGMA				
CCDC34	MAGMA				
ZNF48	MAGMA				
GINS1	MAGMA				
BSN	MAGMA				
NOXO1	MAGMA				
NASP	MAGMA				
LOC101928947	MAGMA				
CDC14A	MAGMA				
CDK11A	MAGMA				
APOBR	MAGMA				
TBL3	MAGMA				
TLR1	MAGMA				
TENM4	MAGMA				
KPNA2	MAGMA				
OGDH	MAGMA				
GPR37L1	MAGMA				
MACROD1	MAGMA				
SIX5	MAGMA				
HSPA1L	MAGMA				
FAM73A	MAGMA				
CST7	MAGMA				
LGI2	MAGMA				
DDB2	MAGMA				
SIRT6	MAGMA				
LOC100996637	MAGMA				
TRA2B	MAGMA				
C19orf43	MAGMA				
GRAMD2	MAGMA				
TRUB2	MAGMA				
ZBTB48	MAGMA				
SMUG1	MAGMA				
ZNF385B	MAGMA				
APOE	MAGMA				
C6orf15	MAGMA				
DAPK3	MAGMA				
IP6K1	MAGMA				
ZNF598	MAGMA				
HSPD1	MAGMA				
N4BP2L2	MAGMA				
APOC4	MAGMA				
ULK4	MAGMA				
NELFE	MAGMA				
MRGPRD	MAGMA				
DNM1	MAGMA				
LYZL4	MAGMA				
SORT1	MAGMA				
NPW	MAGMA				
PPM1K	MAGMA				
SETDB1	MAGMA				
TMEM120B	MAGMA				
NFKB2	MAGMA				
HCRTR2	MAGMA				
ARL13B	MAGMA				
GNAT1	MAGMA				
GMPPA	MAGMA				
DENND1A	MAGMA				
KIAA1324	MAGMA				
ORAI3	MAGMA				
QPRT	MAGMA				
RACGAP1	MAGMA				
PDZD3	MAGMA				
TNXB	MAGMA				
RAB3A	MAGMA				
FAM213B	MAGMA				
C9orf16	MAGMA				
BCAM	MAGMA				
FUS	MAGMA				
AQP2	MAGMA				
GSTM4	MAGMA				
ADAM23	MAGMA				
LACTBL1	MAGMA				
PDE4C	MAGMA				
LSM4	MAGMA				
RAB5B	MAGMA				
HVCN1	MAGMA				
MRGPRF	MAGMA				
HHLA2	MAGMA				
BDH2	MAGMA				
APOBEC2	MAGMA				
DPYD	MAGMA				
MT3	MAGMA				
TTLL4	MAGMA				
CNTFR	MAGMA				
ZNF395	MAGMA				
METTL21A	MAGMA				
SARS	MAGMA				
LOC101929490	MAGMA				
QKI	MAGMA				
MED27	MAGMA				
SLX1A	MAGMA				
DYNC1H1	MAGMA				
ABHD12	MAGMA				
FERMT3	MAGMA				
LSM12	MAGMA				
RPL32	MAGMA				
STX19	MAGMA				
LOC646670	MAGMA				
NTAN1	MAGMA				
LEMD2	MAGMA				
PKHD1	MAGMA				
ZNF655	MAGMA				
TMEM11	MAGMA				
ADGRD2	MAGMA				
LYSMD2	MAGMA				
MARK3	MAGMA				
NEU1	MAGMA				
KRTAP29-1	MAGMA				
PCCB	MAGMA				
ENHO	MAGMA				
ARPC3	MAGMA				
WDR12	MAGMA				
C15orf59	MAGMA				
ANKLE2	MAGMA				
PHF1	MAGMA				
OVCA2	MAGMA				
CATIP	MAGMA				
RABEP2	MAGMA				
C11orf68	MAGMA				
NFYA	MAGMA				
MLN	MAGMA				
PIGF	MAGMA				
GFI1	MAGMA				
FBXO36	MAGMA				
C17orf53	MAGMA				
RPL4	MAGMA				
CHRNA2	MAGMA				
SPDYE5	MAGMA				
C16orf62	MAGMA				
SPATA19	MAGMA				
MLIP	MAGMA				
IRX3	MAGMA				
ELFN1	MAGMA				
COQ10B	MAGMA				
CYSTM1	MAGMA				
SH3PXD2A	MAGMA				
SORCS2	MAGMA				
PCDHGC5	MAGMA				
CYP4A22	MAGMA				
UNC5CL	MAGMA				
OPA3	MAGMA				
ZNF747	MAGMA				
HP	MAGMA				
TRAF7	MAGMA				
PIGL	MAGMA				
HAPLN4	MAGMA				
USP4	MAGMA				
CDSN	MAGMA				
GPBP1L1	MAGMA				
C6orf1	MAGMA				
TBX21	MAGMA				
ARFRP1	MAGMA				
KLHL6	MAGMA				
CHAF1A	MAGMA				
SLC17A9	MAGMA				
HOXB5	MAGMA				
CYP3A5	MAGMA				
PCDHGB4	MAGMA				
TNRC18	MAGMA				
SNTG2	MAGMA				
PACSIN3	MAGMA				
CATSPER1	MAGMA				
HOXB8	MAGMA				
BCKDK	MAGMA				
CTSB	MAGMA				
FBXO46	MAGMA				
LOC101927262	MAGMA				
EHBP1L1	MAGMA				
CAMK2B	MAGMA				
RILPL1	MAGMA				
C1QBP	MAGMA				
VTI1A	MAGMA				
TIMM17A	MAGMA				
FAM114A2	MAGMA				
GLDN	MAGMA				
WNT6	MAGMA				
USP17L2	MAGMA				
PSD2	MAGMA				
FAM3B	MAGMA				
RPS10-NUDT3	MAGMA				
KLHL21	MAGMA				
C2orf61	MAGMA				
FAM177A1	MAGMA				
RER1	MAGMA				
PMVK	MAGMA				
TUBA1A	MAGMA				
CPD	MAGMA				
CHST10	MAGMA				
DNAJB4	MAGMA				
LIMD2	MAGMA				
ASCL2	MAGMA				
THPO	MAGMA				
ENO4	MAGMA				
TM9SF4	MAGMA				
SENP8	MAGMA				
HERC6	MAGMA				
KRTAP1-5	MAGMA				
RAD54B	MAGMA				
PRRT1	MAGMA				
MSANTD3	MAGMA				
MIP	MAGMA				
F2	MAGMA				
GRIA1	MAGMA				
DAND5	MAGMA				
CASC10	MAGMA				
VAX1	MAGMA				
ZDHHC22	MAGMA				
FOXR1	MAGMA				
TCTA	MAGMA				
FDFT1	MAGMA				
CBX1	MAGMA				
CSNK2B	MAGMA				
UBE2D3	MAGMA				
DAGLB	MAGMA				
NCF1	MAGMA				
BCL7A	MAGMA				
AGER	MAGMA				
ANKHD1-EIF4EBP3	MAGMA				
IL31	MAGMA				
TCF19	MAGMA				
ZNF664-FAM101A	MAGMA				
TMEM69	MAGMA				
UBE2J1	MAGMA				
PCDHGA5	MAGMA				
TCFL5	MAGMA				
C6orf48	MAGMA				
ESRP2	MAGMA				
NCKAP5L	MAGMA				
INCA1	MAGMA				
SLC7A6OS	MAGMA				
CCND1	MAGMA				
TRIM35	MAGMA				
HNF4G	MAGMA				
NOL11	MAGMA				
PSMD12	MAGMA				
DNAJC1	MAGMA				
HPCAL4	MAGMA				
TRAIP	MAGMA				
KCNN3	MAGMA				
FKBP5	MAGMA				
BCS1L	MAGMA				
C20orf141	MAGMA				
NUDT22	MAGMA				
CCDC85B	MAGMA				
CALB2	MAGMA				
CD79B	MAGMA				
TMOD2	MAGMA				
MRPS9	MAGMA				
CPA4	MAGMA				
MEGF11	MAGMA				
BTBD10	MAGMA				
KCNAB1	MAGMA				
RAPSN	MAGMA				
COMTD1	MAGMA				
CALCOCO2	MAGMA				
RAMP3	MAGMA				
DNAJC4	MAGMA				
GAP43	MAGMA				
POFUT2	MAGMA				
SAYSD1	MAGMA				
KRTAP4-8	MAGMA				
ZNF536	MAGMA				
MEF2B	MAGMA				
CAND2	MAGMA				
SF3B2	MAGMA				
KAT5	MAGMA				
MDH2	MAGMA				
AMIGO3	MAGMA				
ERH	MAGMA				
PROS1	MAGMA				
LAMA1	MAGMA				
CSHL1	MAGMA				
DERL2	MAGMA				
GRIN2A	MAGMA				
KANK4	MAGMA				
KRT33B	MAGMA				
DHRS7B	MAGMA				
ABHD16B	MAGMA				
KRT34	MAGMA				
NATD1	MAGMA				
SGSM3	MAGMA				
ASIC3	MAGMA				
SPDYA	MAGMA				
DECR2	MAGMA				
KRT31	MAGMA				
MUS81	MAGMA				
EVX1	MAGMA				
DAG1	MAGMA				
PRAC2	MAGMA				
SLC9A3R2	MAGMA				
ALPK1	MAGMA				
GP2	MAGMA				
SPNS1	MAGMA				
RPAP1	MAGMA				
AQP6	MAGMA				
WDPCP	MAGMA				
KNOP1	MAGMA				
SLC14A2	MAGMA				
LSMEM2	MAGMA				
SLC11A1	MAGMA				
SH3GL1	MAGMA				
ZDBF2	MAGMA				
PSRC1	MAGMA				
PCDHGA4	MAGMA				
ARL8A	MAGMA				
CLIC1	MAGMA				
BLK	MAGMA				
FUT8	MAGMA				
CBX2	MAGMA				
BEND5	MAGMA				
IKBKAP	MAGMA				
UPF1	MAGMA				
STYXL1	MAGMA				
NME4	MAGMA				
SLIT1	MAGMA				
HTR3D	MAGMA				
CER1	MAGMA				
CCZ1B	MAGMA				
KCNQ1	MAGMA				
CFAP74	MAGMA				
GCDH	MAGMA				
NLRX1	MAGMA				
BANF1	MAGMA				
CCDC47	MAGMA				
HMBS	MAGMA				
EFR3B	MAGMA				
AVL9	MAGMA				
URAD	MAGMA				
WIBG	MAGMA				
MOCS1	MAGMA				
USP38	MAGMA				
PPARD	MAGMA				
HMGCR	MAGMA				
LOC101927789	MAGMA				
VPS29	MAGMA				
SPEG	MAGMA				
AAAS	MAGMA				
FAM63A	MAGMA				
C4B	MAGMA				
HOXB1	MAGMA				
PDZK1IP1	MAGMA				
COL9A3	MAGMA				
IGHMBP2	MAGMA				
VIL1	MAGMA				
SP7	MAGMA				
CDC27	MAGMA				
USP17L7	MAGMA				
ASNA1	MAGMA				
PSMD9	MAGMA				
DCST1	MAGMA				
KDM5B	MAGMA				
SRCAP	MAGMA				
OBSL1	MAGMA				
GOLGA7B	MAGMA				
UBASH3B	MAGMA				
SLC7A13	MAGMA				
EGFL8	MAGMA				
PRR13	MAGMA				
ERAP2	MAGMA				
PDIA2	MAGMA				
NEIL2	MAGMA				
RCOR1	MAGMA				
TRMT1	MAGMA				
KMT2D	MAGMA				
IGF2BP2	MAGMA				
CENPE	MAGMA				
LEO1	MAGMA				
KRTAP1-3	MAGMA				
CD276	MAGMA				
BRCA2	MAGMA				
GTF2H1	MAGMA				
PCDHGB7	MAGMA				
HACL1	MAGMA				
RAD23A	MAGMA				
STK36	MAGMA				
RNASEH2C	MAGMA				
C9orf153	MAGMA				
IRAK2	MAGMA				
CBX4	MAGMA				
BLMH	MAGMA				
MYO9A	MAGMA				
ADCYAP1	MAGMA				
DUPD1	MAGMA				
GSTM1	MAGMA				
DHH	MAGMA				
RNF167	MAGMA				
AMFR	MAGMA				
DXO	MAGMA				
ZNF705D	MAGMA				
TLR10	MAGMA				
RPS10	MAGMA				
HIC1	MAGMA				
OARD1	MAGMA				
TULP1	MAGMA				
PPP1R14B	MAGMA				
RXFP4	MAGMA				
API5	MAGMA				
TNRC6A	MAGMA				
ELP6	MAGMA				
ITGAD	MAGMA				
RAD9B	MAGMA				
UGGT2	MAGMA				
SERTAD4	MAGMA				
PSD	MAGMA				
APOPT1	MAGMA				
SPI1	MAGMA				
MOGAT3	MAGMA				
SH3YL1	MAGMA				
TREM2	MAGMA				
DEFB134	MAGMA				
HOXB4	MAGMA				
RPGRIP1L	MAGMA				
GOLGA6B	MAGMA				
CDHR4	MAGMA				
ARHGAP1	MAGMA				
MYLK	MAGMA				
KRTAP4-11	MAGMA				
MAPKAPK3	MAGMA				
KRTAP2-1	MAGMA				
SEC22C	MAGMA				
FAM134A	MAGMA				
PURA	MAGMA				
DNPEP	MAGMA				
CSMD2	MAGMA				
PDX1	MAGMA				
NEO1	MAGMA				
SAPCD1	MAGMA				
STAG1	MAGMA				
OSBPL7	MAGMA				
DHX38	MAGMA				
ZNF142	MAGMA				
TMIGD1	MAGMA				
ANKHD1	MAGMA				
SLC38A3	MAGMA				
RPS6KA4	MAGMA				
EML6	MAGMA				
TGFBRAP1	MAGMA				
MASP2	MAGMA				
KRTAP9-1	MAGMA				
PSMG1	MAGMA				
PFDN1	MAGMA				
ZNF408	MAGMA				
RGS11	MAGMA				
ENPP7	MAGMA				
CEMIP	MAGMA				
HMG20A	MAGMA				
ITFG3	MAGMA				
SLC39A13	MAGMA				
GABRD	MAGMA				
LOC100996693	MAGMA				
CAPN11	MAGMA				
WDR53	MAGMA				
CCDC17	MAGMA				
ATXN7L3	MAGMA				
KRTAP4-4	MAGMA				
LOC646730	MAGMA				
SLC25A11	MAGMA				
TMEM126A	MAGMA				
GABRP	MAGMA				
SULT1A3	MAGMA				
TSPO2	MAGMA				
COMP	MAGMA				
SNX11	MAGMA				
PID1	MAGMA				
FARSA	MAGMA				
ABCC5	MAGMA				
TUBA1C	MAGMA				
PTPRG	MAGMA				
PLEKHG5	MAGMA				
FAM206A	MAGMA				
SNAPC5	MAGMA				
ACTL7A	MAGMA				
FAM175B	MAGMA				
KRTAP4-9	MAGMA				
DNAJC27	MAGMA				
TMBIM6	MAGMA				
LY6G6F	MAGMA				
SP2	MAGMA				
CALCR	MAGMA				
BTBD11	MAGMA				
CWC22	MAGMA				
NFE2L1	MAGMA				
STIP1	MAGMA				
SART1	MAGMA				
MAP3K12	MAGMA				
TAF11	MAGMA				
PMAIP1	MAGMA				
IKZF4	MAGMA				
TARBP2	MAGMA				
LMBR1L	MAGMA				
HSPE1	MAGMA				
PCDHGA8	MAGMA				
RBM5	MAGMA				
NCOA1	MAGMA				
ARPC1B	MAGMA				
C2CD2L	MAGMA				
ANKK1	MAGMA				
SSR2	MAGMA				
TTC29	MAGMA				
RNPEP	MAGMA				
VARS	MAGMA				
CD247	MAGMA				
SYT11	MAGMA				
ST5	MAGMA				
ZNF853	MAGMA				
TARDBP	MAGMA				
TNFRSF14	MAGMA				
KBTBD4	MAGMA				
HDGFRP2	MAGMA				
KRTAP3-3	MAGMA				
SLC24A1	MAGMA				
ZNF688	MAGMA				
HDAC11	MAGMA				
APOC2	MAGMA				
PWP1	MAGMA				
NMRK2	MAGMA				
RHOQ	MAGMA				
KRTAP9-2	MAGMA				
ITGAX	MAGMA				
SETD1B	MAGMA				
CDK2	MAGMA				
C16orf93	MAGMA				
SNRNP35	MAGMA				
TIMELESS	MAGMA				
PDE4B	MAGMA				
PLIN5	MAGMA				
GPR84	MAGMA				
PKD1L3	MAGMA				
ZNF26	MAGMA				
SNF8	MAGMA				
HAT1	MAGMA				
H2AFV	MAGMA				
CAMTA2	MAGMA				
ENO3	MAGMA				
NACC1	MAGMA				
CYP17A1	MAGMA				
LRRC1	MAGMA				
ASIC4	MAGMA				
GFER	MAGMA				
ESRP1	MAGMA				
DGKA	MAGMA				
SLC35G2	MAGMA				
GALT	MAGMA				
UBE2Z	MAGMA				
LPPR1	MAGMA				
SMCO1	MAGMA				
STK19	MAGMA				
BCL7B	MAGMA				
PCDHGA11	MAGMA				
MNT	MAGMA				
LY6G5B	MAGMA				
LOXL4	MAGMA				
VASP	MAGMA				
MAP4K2	MAGMA				
ACAP2	MAGMA				
KBTBD2	MAGMA				
YARS	MAGMA				
BAG5	MAGMA				
RELB	MAGMA				
NLRP1	MAGMA				
PBXIP1	MAGMA				
UMOD	MAGMA				
KIAA1586	MAGMA				
ZNF768	MAGMA				
NCK1	MAGMA				
SLC2A4RG	MAGMA				
HCN4	MAGMA				
MIS12	MAGMA				
TMEM59L	MAGMA				
USP36	MAGMA				
LYZ	MAGMA				
NPIPB6	MAGMA				
ITCH	MAGMA				
AK5	MAGMA				
KLHL26	MAGMA				
KRTAP4-7	MAGMA				
TMEM120A	MAGMA				
SLC2A2	MAGMA				
CELSR2	MAGMA				
GABRA5	MAGMA				
LRG1	MAGMA				
PTPMT1	MAGMA				
TRAK1	MAGMA				
PTPRJ	MAGMA				
LSM2	MAGMA				
KRTAP2-4	MAGMA				
ABCB6	MAGMA				
HINFP	MAGMA				
FSBP	MAGMA				
VPS72	MAGMA				
SRM	MAGMA				
RPP25L	MAGMA				
LRRC46	MAGMA				
SLC22A12	MAGMA				
SPRY4	MAGMA				
SOCS5	MAGMA				
POU5F1	MAGMA				
TFEB	MAGMA				
ARHGDIG	MAGMA				
INHA	MAGMA				
KLC2	MAGMA				
LOC101927853	MAGMA				
FASTK	MAGMA				
PCDHGB3	MAGMA				
PCDHGC3	MAGMA				
CD164	MAGMA				
MANBA	MAGMA				
TNFRSF6B	MAGMA				
PRAC1	MAGMA				
SEMA3F	MAGMA				
PCBP2	MAGMA				
ARMC4P1	MAGMA				
GDF1	MAGMA				
KRT33A	MAGMA				
LOC101927998	MAGMA				
KDM2B	MAGMA				
PREX1	MAGMA				
OVOL1	MAGMA				
MAPKBP1	MAGMA				
TOMM40	MAGMA				
SYCE2	MAGMA				
COQ4	MAGMA				
VGF	MAGMA				
DMWD	MAGMA				
BTD	MAGMA				
GSTM5	MAGMA				
APOA4	MAGMA				
POMC	MAGMA				
ZNF689	MAGMA				
HOXA11	MAGMA				
DEDD2	MAGMA				
TXNL4B	MAGMA				
KDELR2	MAGMA				
PIGU	MAGMA				
RPL10L	MAGMA				
GFRAL	MAGMA				
NCAN	MAGMA				
RPS25	MAGMA				
TSGA13	MAGMA				
SHOX2	MAGMA				
EIF1AD	MAGMA				
MARS2	MAGMA				
NFKBIA	MAGMA				
FAM117B	MAGMA				
CRTC1	MAGMA				
CPT1A	MAGMA				
AGBL2	MAGMA				
LMO1	MAGMA				
KIF22	MAGMA				
EIF3CL	MAGMA				
JMJD7-PLA2G4B	MAGMA				
PAGR1	MAGMA				
LOC101927160	MAGMA				
LTK	MAGMA				
ARMC5	MAGMA				
MYL6B	MAGMA				
UBTF	MAGMA				
RAB18	MAGMA				
AMPD2	MAGMA				
ACTN1	MAGMA				
HLA-C	MAGMA				
N4BP2L1	MAGMA				
PITPNC1	MAGMA				
SEMA6B	MAGMA				
AKR1A1	MAGMA				
MON1A	MAGMA				
ANKDD1B	MAGMA				
HTR3E	MAGMA				
IFRD2	MAGMA				
SEC61B	MAGMA				
CBLC	MAGMA				
GPR139	MAGMA				
GPX1	MAGMA				
P2RX7	MAGMA				
NARS2	MAGMA				
SNAPC3	MAGMA				
KRTAP9-9	MAGMA				
TREML1	MAGMA				
MAP1LC3B2	MAGMA				
SEC24A	MAGMA				
WRB	MAGMA				
ZSCAN20	MAGMA				
HOXB7	MAGMA				
GSTM2	MAGMA				
TNPO2	MAGMA				
EPHB2	MAGMA				
ZFAND2B	MAGMA				
NFU1	MAGMA				
B4GALNT2	MAGMA				
BHLHE23	MAGMA				
MAP2K3	MAGMA				
CHPF	MAGMA				
ZBTB46	MAGMA				
RFC5	MAGMA				
DDX56	MAGMA				
HACD2	MAGMA				
HNRNPA1	MAGMA				
TMOD3	MAGMA				
PBX2	MAGMA				
CRB1	MAGMA				
LTBP3	MAGMA				
AMHR2	MAGMA				
DDX20	MAGMA				
RELL2	MAGMA				
BAIAP2	MAGMA				
NUDT21	MAGMA				
FKBP2	MAGMA				
NR1D1	MAGMA				
APOC1	MAGMA				
PYCARD	MAGMA				
ENPP3	MAGMA				
ITGAL	MAGMA				
HSPA12A	MAGMA				
PCDHGA3	MAGMA				
TRMT61A	MAGMA				
KAT2B	MAGMA				
C10orf32	MAGMA				
BTAF1	MAGMA				
VEGFB	MAGMA				
AS3MT	MAGMA				
TMEM54	MAGMA				
NRXN2	MAGMA				
SLC6A17	MAGMA				
TTC26	MAGMA				
WBSCR16	MAGMA				
HYAL1	MAGMA				
NLRC3	MAGMA				
FAM212A	MAGMA				
DUSP13	MAGMA				
EYA2	MAGMA				
C15orf61	MAGMA				
AVP	MAGMA				
ANKZF1	MAGMA				
LBR	MAGMA				
DARS2	MAGMA				
DPH1	MAGMA				
SLC44A4	MAGMA				
RRN3	MAGMA				
ANKS1A	MAGMA				
HYAL3	MAGMA				
TSPAN32	MAGMA				
GS1-259H13.2	MAGMA				
DNASE1	MAGMA				
FIBP	MAGMA				
IL12RB1	MAGMA				
SLC5A11	MAGMA				
CHST8	MAGMA				
SLC22A18AS	MAGMA				
RPL10A	MAGMA				
TLX3	MAGMA				
MYL4	MAGMA				
RNF25	MAGMA				
CHRNE	MAGMA				
MED20	MAGMA				
LAMA2	MAGMA				
NFE2	MAGMA				
REC114	MAGMA				
TMEM160	MAGMA				
MBNL2	MAGMA				
TAF4B	MAGMA				
GAL3ST3	MAGMA				
RAP1A	MAGMA				
ERI1	MAGMA				
LOC100133267	MAGMA				
KRTAP9-3	MAGMA				
ATXN7L2	MAGMA				
SLC6A4	MAGMA				
CLHC1	MAGMA				
AMBRA1	MAGMA				
TMOD4	MAGMA				
PTRHD1	MAGMA				
ZNF764	MAGMA				
ZNF843	MAGMA				
TPD52L2	MAGMA				
PTK2B	MAGMA				
SDCCAG8	MAGMA				
SDHB	MAGMA				
RHOF	MAGMA				
L3MBTL2	MAGMA				
PLIN4	MAGMA				
PKD1	MAGMA				
HES5	MAGMA				
ZFP3	MAGMA				
GNAI2	MAGMA				
SFXN2	MAGMA				
VEPH1	MAGMA				
PHKG2	MAGMA				
FGFBP3	MAGMA				
LOC101929519	MAGMA				
CROCC	MAGMA				
PTPN12	MAGMA				
TMEM60	MAGMA				
SLC22A18	MAGMA				
NOS1	MAGMA				
PKD2	MAGMA				
ACTL7B	MAGMA				
ARPP21	MAGMA				
NR1H3	MAGMA				
ACACA	MAGMA				
KIAA1683	MAGMA				
CREB3L3	MAGMA				
SP6	MAGMA				
SCYL1	MAGMA				
GABPB2	MAGMA				
SYNGR3	MAGMA				
C7orf26	MAGMA				
ZCCHC4	MAGMA				
KRTAP4-3	MAGMA				
FAM150B	MAGMA				
DDX27	MAGMA				
ANKRD10	MAGMA				
TTLL6	MAGMA				
SYT2	MAGMA				
MDH1	MAGMA				
PPP3R2	MAGMA				
APOC3	MAGMA				
APEH	MAGMA				
RAPH1	MAGMA				
PCYT1A	MAGMA				
LOC728392	MAGMA				
ALK	MAGMA				
NPAS1	MAGMA				
MINK1	MAGMA				
FRRS1L	MAGMA				
GON4L	MAGMA				
FAM89B	MAGMA				
KRTAP4-6	MAGMA				
HBEGF	MAGMA				
UBA7	MAGMA				
LMBRD1	MAGMA				
KRTAP1-4	MAGMA				
USP49	MAGMA				
CYP21A2	MAGMA				
IQCH	MAGMA				
ACBD5	MAGMA				
TIPARP	MAGMA				
SPRYD4	MAGMA				
DHRS7C	MAGMA				
EXD2	MAGMA				
PCDHGA7	MAGMA				
TRIM72	MAGMA				
CKB	MAGMA				
TEAD3	MAGMA				
TRMT112	MAGMA				
NOVA2	MAGMA				
ACOX1	MAGMA				
A3GALT2	MAGMA				
EFNA4	MAGMA				
CLPTM1	MAGMA				
LOC100128905	MAGMA				
ZNHIT1	MAGMA				
KRTAP3-2	MAGMA				
ELF3	MAGMA				
COPZ2	MAGMA				
URI1	MAGMA				
C1orf56	MAGMA				
CTSW	MAGMA				
ANGPTL7	MAGMA				
COPZ1	MAGMA				
MRPL28	MAGMA				
SND1	MAGMA				
NPIPB8	MAGMA				
CNGB3	MAGMA				
DHX33	MAGMA				
CCHCR1	MAGMA				
SYPL2	MAGMA				
ZSCAN26	MAGMA				
FAM216A	MAGMA				
HOXB3	MAGMA				
APMAP	MAGMA				
RASGRP2	MAGMA				
ARHGEF2	MAGMA				
LRRC4	MAGMA				
TSC2	MAGMA				
ETS2	MAGMA				
SCN4A	MAGMA				
PRDX1	MAGMA				
EHMT2	MAGMA				
ACP2	MAGMA				
ECE2	MAGMA				
CASC3	MAGMA				
GTF3A	MAGMA				
MAU2	MAGMA				
POU4F1	MAGMA				
ERAP1	MAGMA				
PLCH2	MAGMA				
GIP	MAGMA				
CDX2	MAGMA				
ADGRL2	MAGMA				
C4A	MAGMA				
ACTR1A	MAGMA				
HOXB13	MAGMA				
PPARG	MAGMA				
AEBP2	MAGMA				
ORMDL3	MAGMA				
PRDM4	MAGMA				
DMPK	MAGMA				
RHOA	MAGMA				
KIFC1	MAGMA				
RAB26	MAGMA				
NUPR1	MAGMA				
DCTN3	MAGMA				
ZWILCH	MAGMA				
HTR3C	MAGMA				
KRTAP17-1	MAGMA				
RBMS2	MAGMA				
ANKS6	MAGMA				
TRIM65	MAGMA				
MEF2BNB-MEF2B	MAGMA				
GLB1L	MAGMA				
TP53INP2	MAGMA				
MYL6	MAGMA				
MASTL	MAGMA				
ZNF771	MAGMA				
LIPH	MAGMA				
RNF103	MAGMA				
CENPO	MAGMA				
TSHZ2	MAGMA				
RPL22L1	MAGMA				
PPTC7	MAGMA				
OTX1	MAGMA				
DNAJC3	MAGMA				
DYM	MAGMA				
PTGFR	MAGMA				
TMEM8A	MAGMA				
LRRC25	MAGMA				
TUBA1B	MAGMA				
LRRC43	MAGMA				
SSR3	MAGMA				
MPND	MAGMA				
TRAT1	MAGMA				
LY6G6C	MAGMA				
FGF19	MAGMA				
CTF1	MAGMA				
ZBTB43	MAGMA				
IP6K3	MAGMA				
ATP5J2-PTCD1	MAGMA				
ANXA9	MAGMA				
NR5A1	MAGMA				
SRR	MAGMA				
ATP2A1	MAGMA				
KIAA1524	MAGMA				
CPA2	MAGMA				
JMJD7	MAGMA				
ERN2	MAGMA				
NR2C2AP	MAGMA				
CKS1B	MAGMA				
ANAPC7	MAGMA				
ZDHHC4	MAGMA				
INS-IGF2	MAGMA				
PEAK1	MAGMA				
LEPROT	MAGMA				
CUEDC2	MAGMA				
DYNLL2	MAGMA				
MYBPC3	MAGMA				
CDC42SE1	MAGMA				
C17orf107	MAGMA				
HPR	MAGMA				
CLCN2	MAGMA				
SLC22A11	MAGMA				
POC1B-GALNT4	MAGMA				
RAB27B	MAGMA				
ENDOV	MAGMA				
LUC7L	MAGMA				
ZNF76	MAGMA				
KRTAP9-6	MAGMA				
QPCTL	MAGMA				
CRB2	MAGMA				
AKTIP	MAGMA				
MPV17L2	MAGMA				
WWC1	MAGMA				
CLDN23	MAGMA				
FKBPL	MAGMA				
NAT6	MAGMA				
DRD2	MAGMA				
UNC13D	MAGMA				
PRUNE	MAGMA				
EXOC3L2	MAGMA				
PPP1R3B	MAGMA				
RNF19B	MAGMA				
SAMD8	MAGMA				
CALR	MAGMA				
PCDHGC4	MAGMA				
DES	MAGMA				
HLA-DMB	MAGMA				
CERS1	MAGMA				
XRCC3	MAGMA				
HOXA10	MAGMA				
ITPKA	MAGMA				
PIP5K1A	MAGMA				
GH2	MAGMA				
CSF3	MAGMA				
ABCE1	MAGMA				
MMACHC	MAGMA				
UNK	MAGMA				
RAD52	MAGMA				
EDNRB	MAGMA				
SLIT3	MAGMA				
FAM167A	MAGMA				
RHEBL1	MAGMA				
RCVRN	MAGMA				
TCTN1	MAGMA				
PHC2	MAGMA				
PPP2R5C	MAGMA				
GPN3	MAGMA				
PDILT	MAGMA				
TFAP2D	MAGMA				
RPS26	MAGMA				
TMUB2	MAGMA				
LOC101060391	MAGMA				
TRPT1	MAGMA				
CWC27	MAGMA				
MAP6D1	MAGMA				
HARBI1	MAGMA				
NICN1	MAGMA				
EIF5A2	MAGMA				
DDAH2	MAGMA				
RAB11FIP3	MAGMA				
FGF4	MAGMA				
VPS11	MAGMA				
GPR45	MAGMA				
PARP6	MAGMA				
FAM220A	MAGMA				
FBXO5	MAGMA				
ZDHHC19	MAGMA				
NOX4	MAGMA				
NPIPA1	MAGMA				
DPH6	MAGMA				
GALNT12	MAGMA				
POMGNT1	MAGMA				
KRTAP4-2	MAGMA				
CRLF1	MAGMA				
NRG2	MAGMA				
COL4A3BP	MAGMA				
PRR15L	MAGMA				
VPS37D	MAGMA				
MADD	MAGMA				
SLC4A2	MAGMA				
STK33	MAGMA				
HSPA1A	MAGMA				
SUGP1	MAGMA				
TCTEX1D2	MAGMA				
PCDHGB2	MAGMA				
LCTL	MAGMA				
CISD2	MAGMA				
ABCG4	MAGMA				
BHMG1	MAGMA				
LRRC3C	MAGMA				
PLCD4	MAGMA				
KCNH6	MAGMA				
RBL2	MAGMA				
PPIA	MAGMA				
PRKAG3	MAGMA				
CSE1L	MAGMA				
LACE1	MAGMA				
ARFGAP2	MAGMA				
ATG13	MAGMA				
PMFBP1	MAGMA				
PRSS3	MAGMA				
DEF6	MAGMA				
GPR149	MAGMA				
ERICH3	MAGMA				
RETNLB	MAGMA				
SEMA3B	MAGMA				
ASB16	MAGMA				
RIOK3	MAGMA				
ANKRD24	MAGMA				
GID8	MAGMA				
PCDHGA12	MAGMA				
ARHGAP19	MAGMA				
TTC7A	MAGMA				
ATG9A	MAGMA				
ELP3	MAGMA				
BRINP1	MAGMA				
SLC35C2	MAGMA				
ARAP3	MAGMA				
MST1	MAGMA				
H2AFX	MAGMA				
DEFB135	MAGMA				
GOSR1	MAGMA				
NANP	MAGMA				
PLOD3	MAGMA				
TMEM63B	MAGMA				
TYRO3	MAGMA				
RSPH10B2	MAGMA				
RNF5	MAGMA				
HYDIN	MAGMA				
MMEL1	MAGMA				
LOC100134391	MAGMA				
MYLPF	MAGMA				
UBAP1	MAGMA				
SLC35E2B	MAGMA				
DYNLRB1	MAGMA				
CSH1	MAGMA				
ATG16L2	MAGMA				
SKIV2L	MAGMA				
ORAOV1	MAGMA				
PRR14	MAGMA				
MSANTD3-TMEFF1	MAGMA				
SIGMAR1	MAGMA				
SLC35G5	MAGMA				
AMIGO1	MAGMA				
ATG9B	MAGMA				
SLC9B2	MAGMA				
RFXANK	MAGMA				
NUDT3	MAGMA				
ANKRD31	MAGMA				
CCND3	MAGMA				
IL27	MAGMA				
MAZ	MAGMA				
RSPH6A	MAGMA				
FOXA3	MAGMA				
RSBN1L	MAGMA				
PVRL2	MAGMA				
ZNF629	MAGMA				
GALNT4	MAGMA				
EPHX2	MAGMA				
USP37	MAGMA				
CORO6	MAGMA				
PTPN7	MAGMA				
KIF3B	MAGMA				
TMEM265	MAGMA				
KRTAP1-1	MAGMA				
MTMR9	MAGMA				
CASKIN1	MAGMA				
NANOS2	MAGMA				
FAM131A	MAGMA				
DPH3P1	MAGMA				
PP2D1	MAGMA				
MAST1	MAGMA				
MVP	MAGMA				
KRTAP16-1	MAGMA				
TSGA10IP	MAGMA				
BCL7C	MAGMA				
FXR1	MAGMA				
SF1	MAGMA				
ZNF316	MAGMA				
CCDC68	MAGMA				
ACSM5	MAGMA				
LY6G5C	MAGMA				
HSD3B7	MAGMA				
DNAJC6	MAGMA				
ACE	MAGMA				
ITGAM	MAGMA				
EML2	MAGMA				
DHFRL1	MAGMA				
SLC37A4	MAGMA				
TAGLN	MAGMA				
CPA1	MAGMA				
PPT2	MAGMA				
ZBTB37	MAGMA				
WBP1L	MAGMA				
PCDHGA2	MAGMA				
PPP1R2	MAGMA				
ACSS1	MAGMA				
GIT1	MAGMA				
TUBA4A	MAGMA				
ZNF394	MAGMA				
HPD	MAGMA				
SYNDIG1	MAGMA				
SREK1IP1	MAGMA				
EEF2	MAGMA				
SMYD4	MAGMA				
R3HCC1L	MAGMA				
MEN1	MAGMA				
GPR65	MAGMA				
TCP11	MAGMA				
SS18	MAGMA				
C11orf21	MAGMA				
NPFF	MAGMA				
LOC100652807	MAGMA				
TYW3	MAGMA				
LURAP1	MAGMA				
TBX4	MAGMA				
HSPE1-MOB4	MAGMA				
KRTAP4-5	MAGMA				
LOC100506944	MAGMA				
PMEL	MAGMA				
CHP2	MAGMA				
LY6G6D	MAGMA				
MYH15	MAGMA				
FBXL15	MAGMA				
TBCC	MAGMA				
ERICH2	MAGMA				
STX17	MAGMA				
DUSP6	MAGMA				
ADGRB3	MAGMA				
GMPPB	MAGMA				
KLF7	MAGMA				
C17orf58	MAGMA				
LIME1	MAGMA				
MAPK6	MAGMA				
FRMD8	MAGMA				
DNASE2	MAGMA				
MSH5	MAGMA				
KIAA0907	MAGMA				
IGF2	MAGMA				
CCDC182	MAGMA				
NUCB2	MAGMA				
SENP2	MAGMA				
PLXDC2	MAGMA				
GRID2IP	MAGMA				
ASCL4	MAGMA				
NFIX	MAGMA				
KRTAP9-8	MAGMA				
EIF5	MAGMA				
SEPSECS	MAGMA				
NFIB	MAGMA				
PSORS1C1	MAGMA				
LPA	MAGMA				
COL4A4	MAGMA				
UQCC2	MAGMA				
NPC1L1	MAGMA				
PACSIN1	MAGMA				
FNBP4	MAGMA				
STIL	MAGMA				
CBL	MAGMA				
KRTAP3-1	MAGMA				
RPL5	MAGMA				
LSM5	MAGMA				
MGA	MAGMA				
GPR4	MAGMA				
IRF2BP1	MAGMA				
ODF3L1	MAGMA				
ATP6V1E2	MAGMA				
FLT3	MAGMA				
MT4	MAGMA				
ZNF451	MAGMA				
SYMPK	MAGMA				
SEMA6C	MAGMA				
NUP160	MAGMA				
ACSM2A	MAGMA				
ERBB3	MAGMA				
SDK1	MAGMA				
FAM46A	MAGMA				
AP5B1	MAGMA				
PLA2G15	MAGMA				
MOK	MAGMA				
CCDC101	MAGMA				
SLC4A9	MAGMA				
FIGNL1	MAGMA				
JUNB	MAGMA				
ENTPD4	MAGMA				
NAT16	MAGMA				
LOC101929185	MAGMA				
CYP27A1	MAGMA				
DCTPP1	MAGMA				
INTS9	MAGMA				
ZBTB9	MAGMA				
SPDEF	MAGMA				
ZSCAN25	MAGMA				
ZNF526	MAGMA				
PABPC4	MAGMA				
TTC34	MAGMA				
TMEM245	MAGMA				
ARL14EP	MAGMA				
SRSF1	MAGMA				
RPA1	MAGMA				
RAB29	MAGMA				
IFI30	MAGMA				
DDN	MAGMA				
CORO1A	MAGMA				
LOC101928120	MAGMA				
C19orf12	MAGMA				
GLTSCR1L	MAGMA				
CST6	MAGMA				
GPSM3	MAGMA				
GADD45GIP1	MAGMA				
SLC27A4	MAGMA				
MTRF1L	MAGMA				
C6orf229	MAGMA				
EFEMP2	MAGMA				
TSNARE1	MAGMA				
PCDHGB5	MAGMA				
CD19	MAGMA				
CEBPG	MAGMA				
TNS4	MAGMA				
FAM69A	MAGMA				
IQSEC1	MAGMA				
PLAGL2	MAGMA				
NEXN	MAGMA				
VWA7	MAGMA				
CRYZ	MAGMA				
TAS1R1	MAGMA				
WBP2	MAGMA				
CASZ1	MAGMA				
ANKRD29	MAGMA				
HOXB6	MAGMA				
VAMP3	MAGMA				
STAP2	MAGMA				
KIF1C	MAGMA				
CTDSP1	MAGMA				
PARL	MAGMA				
PAX8	MAGMA				
SIDT2	MAGMA				
SCAMP1	MAGMA				
FEZF2	MAGMA				
RPL27A	MAGMA				
OGFR	MAGMA				
DDC	MAGMA				
KRTAP2-3	MAGMA				
CSH2	MAGMA				
PADI2	MAGMA				
WRN	MAGMA				
ADSL	MAGMA				
ANAPC5	MAGMA				
LNX2	MAGMA				
ERP44	MAGMA				
RIT1	MAGMA				
POLR2H	MAGMA				
ERF	MAGMA				
ARL3	MAGMA				
AAGAB	MAGMA				
PRDX2	MAGMA				
SALL4	MAGMA				
NOTCH4	MAGMA				
NSRP1	MAGMA				
GCNT4	MAGMA				
TMEM17	MAGMA				
SKIDA1	MAGMA				
CDKN1C	MAGMA				
OPRM1	MAGMA				
TMEM198	MAGMA				
ACTB	MAGMA				
KCNC4	MAGMA				
TSPAN1	MAGMA				
AQP5	MAGMA				
KRTAP4-1	MAGMA				
CEP41	MAGMA				
GBF1	MAGMA				
C3orf18	MAGMA				
RNASEH2A	MAGMA				
SUFU	MAGMA				
RBMS3	MAGMA				
SSSCA1	MAGMA				
ALG3	MAGMA				
BEND6	MAGMA				
RNF40	MAGMA				
NOL9	MAGMA				
MRPL21	MAGMA				
SMG6	MAGMA				
PSORS1C2	MAGMA				
PEX10	MAGMA				
KLC1	MAGMA				
AMN	MAGMA				
CIZ1	MAGMA				
GPR137	MAGMA				
UBXN6	MAGMA				
TBC1D10B	MAGMA				
PTCHD3	MAGMA				
ZFYVE21	MAGMA				
BEST2	MAGMA				
MDN1	MAGMA				
SLC45A3	MAGMA				
CTNNAL1	MAGMA				
RPL41	MAGMA				
DRAP1	MAGMA				
CDK5	MAGMA				
KIAA2013	MAGMA				
CPA5	MAGMA				
HLA-B	MAGMA				
WSB2	MAGMA				
PKM	MAGMA				
C19orf60	MAGMA				
HSPA1B	MAGMA				
CEP295NL	MAGMA				
ARFGEF1	MAGMA				
CAMKV	MAGMA				
TRAPPC4	MAGMA				
COX6A2	MAGMA				
GPANK1	MAGMA				
PPP2R3C	MAGMA				
CFB	MAGMA				
VWA5B2	MAGMA				
UBIAD1	MAGMA				
CDC42BPB	MAGMA				
NPTX1	MAGMA				
CYB561D1	MAGMA				
SGSM2	MAGMA				
ZC3H10	MAGMA				
NDUFS5	MAGMA				
POFUT1	MAGMA				
1-Sep	MAGMA				
LYSMD1	MAGMA				
C6orf25	MAGMA				
TSR1	MAGMA				
MEF2BNB	MAGMA				
MYPOP	MAGMA				
TMEM126B	MAGMA				
DPY19L4	MAGMA				
HEMK1	MAGMA				
GMNN	MAGMA				
FAM159B	MAGMA				
EFNA3	MAGMA				
FBXO45	MAGMA				
GRM4	MAGMA				
LRP4	MAGMA				
SIK3	MAGMA				
KSR2	MAGMA				
RRAGD	MAGMA				
EIF2S2	MAGMA				
CKAP5	MAGMA				
TTC17	MAGMA				
KRTAP9-7	MAGMA				
GH1	MAGMA				
PFN1	MAGMA				
HPS5	MAGMA				
GNAT2	MAGMA				
TIMP2	MAGMA				
ITGB3	MAGMA				
CARF	MAGMA				
GTF2IRD1	MAGMA				
KRTAP9-4	MAGMA				
PIGW	MAGMA				
SAE1	MAGMA				
CERS2	MAGMA				
C1orf127	MAGMA				
PLAC4	MAGMA				
AMT	MAGMA				
PRSS8	MAGMA				
RASL11A	MAGMA				
DIS3L	MAGMA				
CERCAM	MAGMA				
LCN2	MAGMA				
CACNA2D4	MAGMA				
VIPR1	MAGMA				
FANCE	MAGMA				
FBXL18	MAGMA				
MKL1	MAGMA				
FREM1	MAGMA				
IFT57	MAGMA				
TBC1D29	MAGMA				
IL20RB	MAGMA				
PRSS36	MAGMA				
SERPINC1	MAGMA				
SPAG7	MAGMA				
KCTD21	MAGMA				
TACO1	MAGMA				
DOCK3	MAGMA				
ZNF385A	MAGMA				
NR1I2	MAGMA				
FEZ2	MAGMA				
C6orf47	MAGMA				
SLC9B1	MAGMA				
IGIP	MAGMA				
APOA1	MAGMA				
SEPHS2	MAGMA				
PYGM	MAGMA				
PRICKLE1	MAGMA				
ZNFX1	MAGMA				
KCNK5	MAGMA				
ZNF12	MAGMA				
PANK4	MAGMA				
PLA2G4B	MAGMA				
L1TD1	MAGMA				
DNER	MAGMA				
DLX1	MAGMA				
CCDC67	MAGMA				
DPAGT1	MAGMA				
GEM	MAGMA				
ATCAY	MAGMA				
TM4SF19	MAGMA				
ALKBH3	MAGMA				
TESC	MAGMA				
TM6SF2	MAGMA				
PARD3	MAGMA				
DHODH	MAGMA				
ATP2A2	MAGMA				
LGR4	MAGMA				
PRRT2	MAGMA				
PCDHGA6	MAGMA				
PRSS53	MAGMA				
C1orf234	MAGMA				
UBE2D2	MAGMA				
ZGPAT	MAGMA				
SDCBP2	MAGMA				
HOXB2	MAGMA				
RUNDC3A	MAGMA				
CISH	MAGMA				
E2F3	MAGMA				
TNFAIP8L2	MAGMA				
PHTF2	MAGMA				
CUTA	MAGMA				
HEYL	MAGMA				
ADCY9	MAGMA				
CALML6	MAGMA				
TM4SF5	MAGMA				
G6PC3	MAGMA				
PNPO	MAGMA				
NT5C1A	MAGMA				
SUOX	MAGMA				
FKBP1A	MAGMA				
SCNM1	MAGMA				
ABCB8	MAGMA				
TMED4	MAGMA				
NPAS3	MAGMA				
FOSL1	MAGMA				
PCDHGB1	MAGMA				
C17orf51	MAGMA				
URM1	MAGMA				
CLN3	MAGMA				
STX4	MAGMA				
MYBPHL	MAGMA				
TNFAIP8L2-SCNM1	MAGMA				
ZAK	MAGMA				
TRAP1	MAGMA				
WAPAL	MAGMA				
PYDC1	MAGMA				
TRIM8	MAGMA				
SAR1B	MAGMA				
BOLA2B	MAGMA				
KAT6B	MAGMA				
PEPD	MAGMA				
SLC51A	MAGMA				
GLS2	MAGMA				
GATA4	MAGMA				
VDAC2	MAGMA				
WDR66	MAGMA				
VHL	MAGMA				
PRKAG1	MAGMA				
IGF2BP1	MAGMA				
ABHD16A	MAGMA				
ATP5G1	MAGMA				
FCHSD1	MAGMA				
CAMK2N2	MAGMA				
FLRT1	MAGMA				
KLHL24	MAGMA				
IL11RA	MAGMA				
ITPR3	MAGMA				
DNAJC19	MAGMA				
SNRPD2	MAGMA				
TPX2	DEPICT				
PLEKHG4	DEPICT				
KCTD10	DEPICT				
ZNF518B	DEPICT				
CTNNB1	DEPICT				
GCFC1	DEPICT				
OIP5	DEPICT				
C1orf183	DEPICT				
KCNH3	DEPICT				
CTC-436K13.5	DEPICT				
UBE3B	DEPICT				
USP33	DEPICT				
POLE	DEPICT				
C20orf11	DEPICT				
BNIP3L	DEPICT				
LINC00599	DEPICT				
PRPF40B	DEPICT				
INO80	DEPICT				
ATPBD4	DEPICT				
FAM13B	DEPICT				
EPM2AIP1	DEPICT				
MAP4	DEPICT				
ATP6V0D1	DEPICT				
ODZ2	DEPICT				
FAM5C	DEPICT				
MCRS1	DEPICT				
DHX30	DEPICT				
MIR548N	DEPICT				
DUSP26	DEPICT				
FAM53C	DEPICT				
TNKS	DEPICT				
KDM3B	DEPICT				
C9orf4	DEPICT				
CBFB	DEPICT				
FMNL3	DEPICT				
FHOD1	DEPICT				
FLJ20373	DEPICT				
PAFAH1B2	DEPICT				
RP11-261C10.3	DEPICT				
SOX2-OT	DEPICT				
ZSWIM5	DEPICT				
SYNJ1	DEPICT				
FAM190A	DEPICT				
SCRIB	DEPICT				
KIF20A	DEPICT				
PLEKHM2	DEPICT				
NUSAP1	DEPICT				